0, 0, 0, 5, 0, 0, 0
0, 0, 5, 6, 5, 0, 0
0, 5, 5, 7, 6, 5, 0
5, 6, 7, 8, 7, 6, 5
0, 5, 6, 7, 5, 5, 0
0, 0, 5, 6, 5, 0, 0
0, 0, 0, 5, 0, 0, 0